111111111111
101010111001
101110101001
101010111001
10E0C0111101
1000P0C10101
111111111111