111111111111
101010111001
101110101001
101010111001
10P0E0101001
10CCCCCCC001
111111111111