111111111
100000001
100000C01
1P0000001
1E1000F01
1C1111001
111111111