111111111
100000011
100000011
1P0111011
1000100E1
1C1111101
111111111