11111111
10101011
10111011
10101011
100PCE01
10000001
11111111