111111111
1P1111001
1E1111001
1C1111001
111111111