11111111
101PCE01
10101101
11111111