11111111111
101010CCC11
10101CCC011
100PCCCCE01
10CCCCC0001
11111111111