111111111111
101010111001
101110101001
101010111001
100C0E001101
1000P0C10101
111111111111