111111111
1000F0011
100000011
1P0111F11
10F0100E1
1C1111101
111111111