111111111
1000F0011
100000011
1P0111011
1000000E1
1C1111101
111111111