111111111111
10101C111001
10111C101001
101010111001
1CCC0E001101
1000P0C10101
111111111111