111111111
100000011
10000F011
10P111F11
1000100E1
1C1111101
111111111
